4, 4, 1, 1, 4, 7, 1, 1, 4, 1, 1, 4, 7, 1, 4, 4, 7, 1, 1, 1, 1, 4, 7, 1, 1, 7, 1, 4, 1, 7, 1, 1, 1, 7, 1, 1, 7, 1, 7, 1, 1, 4, 7, 1, 1, 1, 4, 1, 7, 4, 1, 1, 7, 4, 1, 7
1, 0, 0, 0, 0, 0, 0, 0, 0, 0, 0, 0, 0, 1, 4, 0, 0, 0, 0, 0, 0, 0, 0, 0, 0, 0, 0, 0, 0, 0, 0, 0, 0, 0, 0, 0, 0, 0, 0, 0, 0, 1, 4, 0, 0, 0, 0, 0, 0, 0, 0, 0, 0, 0, 0, 1
7, 0, 1, 1, 4, 1, 0, 1, 4, 1, 1, 1, 0, 4, 1, 0, 1, 4, 1, 1, 4, 0, 1, 4, 1, 1, 0, 4, 1, 0, 1, 1, 4, 1, 0, 1, 1, 4, 1, 1, 0, 1, 1, 0, 1, 4, 1, 1, 4, 0, 1, 4, 1, 4, 0, 1
4, 0, 1, 9, 16, 1, 0, 1, 16, 10, 9, 4, 0, 1, 1, 0, 1, 10, 9, 16, 1, 0, 1, 16, 10, 1, 0, 1, 1, 0, 1, 16, 9, 1, 0, 1, 9, 10, 16, 1, 0, 1, 1, 0, 1, 16, 9, 10, 1, 0, 1, 10, 16, 1, 0, 4
1, 0, 1, 4, 1, 1, 0, 4, 1, 1, 1, 1, 0, 4, 1, 0, 1, 4, 1, 1, 4, 0, 1, 1, 1, 4, 0, 4, 1, 0, 1, 4, 1, 1, 0, 1, 4, 1, 1, 1, 0, 1, 4, 0, 4, 1, 1, 4, 4, 0, 4, 1, 1, 4, 0, 7
7, 0, 0, 0, 0, 0, 0, 0, 0, 0, 0, 0, 0, 0, 0, 0, 0, 0, 0, 0, 0, 0, 0, 0, 0, 0, 0, 1, 1, 0, 0, 0, 0, 0, 0, 0, 0, 0, 0, 0, 0, 0, 0, 0, 0, 0, 0, 0, 0, 0, 0, 0, 0, 0, 0, 1
1, 0, 4, 1, 4, 1, 0, 4, 1, 0, 4, 1, 1, 4, 1, 4, 1, 1, 0, 4, 1, 0, 1, 4, 1, 4, 0, 1, 4, 0, 1, 1, 4, 1, 0, 4, 1, 0, 1, 4, 1, 4, 1, 1, 4, 1, 0, 4, 1, 0, 1, 4, 1, 1, 0, 7
4, 0, 1, 1, 4, 1, 0, 4, 1, 0, 1, 4, 1, 4, 4, 1, 4, 1, 0, 1, 4, 0, 1, 1, 4, 1, 0, 4, 1, 0, 1, 4, 1, 1, 0, 1, 1, 0, 4, 1, 1, 4, 1, 1, 4, 1, 0, 1, 1, 0, 4, 1, 1, 1, 0, 4
1, 0, 0, 0, 0, 0, 0, 1, 1, 0, 0, 0, 0, 1, 1, 0, 0, 0, 0, 1, 1, 0, 0, 0, 0, 0, 0, 0, 0, 0, 0, 0, 0, 0, 0, 1, 1, 0, 0, 0, 0, 1, 1, 0, 0, 0, 0, 1, 1, 0, 0, 0, 0, 0, 0, 1
7, 1, 4, 1, 1, 4, 0, 1, 4, 1, 1, 4, 0, 1, 4, 0, 1, 4, 1, 4, 1, 0, 4, 1, 4, 1, 1, 4, 1, 4, 1, 1, 1, 4, 0, 1, 4, 1, 1, 1, 0, 1, 4, 0, 1, 1, 4, 1, 4, 0, 1, 4, 1, 4, 1, 4
1, 10, 9, 16, 9, 1, 0, 4, 1, 4, 1, 1, 0, 4, 1, 0, 1, 1, 1, 4, 1, 0, 1, 4, 1, 1, 4, 1, 1, 4, 1, 1, 4, 1, 0, 4, 1, 1, 1, 4, 0, 1, 1, 0, 4, 1, 1, 4, 1, 0, 4, 9, 10, 9, 16, 7
1, 16, 10, 16, 16, 4, 0, 4, 1, 0, 0, 0, 0, 0, 0, 0, 0, 0, 0, 1, 4, 0, 0, 0, 0, 0, 0, 0, 0, 0, 0, 0, 0, 0, 0, 1, 1, 0, 0, 0, 0, 0, 0, 0, 0, 0, 0, 4, 1, 0, 4, 16, 16, 10, 9, 1
4, 9, 16, 10, 9, 1, 0, 4, 1, 0, 4, 1, 1, 4, 1, 1, 4, 1, 0, 1, 4, 0, 1, 4, 1, 1, 4, 1, 1, 4, 1, 1, 4, 1, 0, 4, 1, 0, 1, 1, 4, 1, 1, 4, 1, 1, 0, 1, 4, 0, 1, 10, 16, 16, 10, 1
7, 10, 16, 9, 10, 4, 0, 1, 1, 0, 1, 9, 16, 9, 10, 16, 10, 1, 0, 4, 1, 0, 4, 14, 5, 4, 4, 15, 4, 15, 13, 14, 5, 1, 0, 4, 1, 0, 1, 10, 16, 10, 16, 9, 9, 4, 0, 1, 4, 0, 1, 16, 10, 16, 9, 7
1, 16, 10, 16, 16, 1, 0, 0, 0, 0, 4, 16, 10, 9, 16, 10, 9, 1, 0, 0, 0, 0, 1, 13, 14, 15, 14, 14, 12, 14, 11, 4, 14, 4, 0, 0, 0, 0, 1, 16, 10, 9, 16, 10, 16, 4, 0, 0, 0, 0, 4, 9, 9, 10, 9, 1
4, 9, 9, 10, 9, 4, 0, 1, 4, 0, 1, 10, 16, 10, 9, 16, 16, 1, 0, 1, 4, 0, 4, 5, 2, 15, 12, 4, 13, 5, 15, 14, 13, 1, 0, 4, 1, 0, 4, 9, 16, 9, 10, 16, 10, 1, 0, 4, 1, 0, 1, 10, 16, 16, 10, 1
1, 10, 16, 16, 10, 1, 0, 4, 1, 0, 4, 1, 1, 4, 1, 1, 4, 1, 0, 1, 1, 0, 1, 1, 1, 1, 4, 1, 1, 1, 4, 1, 4, 1, 0, 1, 1, 0, 1, 4, 1, 1, 1, 1, 4, 1, 0, 1, 1, 0, 1, 16, 10, 16, 16, 1
7, 16, 10, 16, 9, 1, 0, 4, 1, 0, 0, 0, 0, 0, 0, 0, 0, 0, 0, 4, 1, 0, 0, 0, 0, 0, 0, 0, 0, 0, 0, 0, 0, 0, 0, 4, 1, 0, 0, 0, 0, 0, 0, 0, 0, 0, 0, 1, 4, 0, 4, 16, 16, 10, 16, 7
1, 9, 16, 10, 9, 1, 0, 4, 1, 0, 1, 4, 1, 4, 1, 1, 4, 1, 0, 1, 1, 0, 1, 4, 1, 4, 1, 4, 1, 1, 4, 1, 4, 1, 0, 4, 1, 0, 1, 1, 1, 4, 1, 4, 1, 1, 0, 4, 1, 0, 4, 9, 9, 9, 10, 1
4, 1, 1, 1, 1, 1, 0, 1, 1, 0, 1, 1, 1, 4, 1, 4, 4, 1, 0, 1, 4, 0, 1, 1, 4, 1, 1, 4, 1, 1, 4, 1, 1, 4, 0, 1, 1, 0, 1, 4, 1, 1, 4, 1, 1, 4, 0, 1, 4, 0, 4, 1, 1, 4, 1, 4
1, 0, 0, 0, 0, 0, 0, 0, 0, 0, 0, 0, 0, 1, 4, 0, 0, 0, 0, 0, 0, 0, 0, 0, 0, 0, 0, 0, 0, 0, 0, 0, 0, 0, 0, 0, 0, 0, 0, 0, 0, 1, 4, 0, 0, 0, 0, 0, 0, 0, 0, 0, 0, 0, 0, 7
7, 0, 1, 1, 4, 1, 0, 1, 4, 1, 1, 4, 0, 1, 1, 0, 1, 4, 1, 4, 1, 0, 1, 4, 1, 4, 0, 1, 4, 0, 1, 4, 1, 1, 0, 1, 4, 1, 4, 1, 0, 1, 1, 0, 1, 4, 1, 1, 4, 0, 1, 4, 1, 1, 0, 4
4, 0, 4, 1, 4, 1, 0, 1, 1, 4, 1, 1, 0, 4, 1, 0, 1, 1, 4, 1, 1, 0, 4, 1, 1, 1, 0, 4, 1, 0, 1, 1, 4, 1, 0, 1, 1, 4, 1, 1, 0, 4, 1, 0, 1, 1, 4, 1, 1, 0, 1, 1, 4, 1, 0, 1
4, 0, 0, 0, 1, 4, 0, 0, 0, 0, 0, 0, 0, 0, 0, 0, 0, 0, 0, 0, 0, 0, 1, 4, 0, 0, 0, 1, 4, 0, 0, 0, 1, 4, 0, 0, 0, 0, 0, 0, 0, 0, 0, 0, 0, 0, 0, 0, 0, 0, 4, 1, 0, 0, 0, 7
1, 4, 1, 0, 1, 1, 0, 1, 1, 0, 1, 4, 1, 4, 1, 4, 1, 1, 0, 4, 1, 0, 1, 1, 0, 1, 4, 1, 1, 4, 1, 0, 1, 1, 0, 4, 1, 0, 4, 1, 1, 4, 1, 4, 1, 1, 0, 4, 1, 0, 4, 1, 0, 4, 1, 4
7, 1, 4, 0, 1, 1, 0, 1, 4, 0, 1, 1, 4, 1, 1, 4, 1, 1, 0, 1, 4, 0, 1, 1, 0, 1, 4, 1, 1, 1, 4, 0, 1, 4, 0, 1, 1, 0, 1, 4, 1, 1, 1, 4, 1, 4, 0, 1, 1, 0, 1, 1, 0, 1, 1, 1
1, 0, 0, 0, 0, 0, 0, 4, 1, 0, 0, 0, 0, 4, 1, 0, 0, 0, 0, 1, 4, 0, 0, 0, 0, 0, 0, 4, 1, 0, 0, 0, 0, 0, 0, 4, 1, 0, 0, 0, 0, 4, 1, 0, 0, 0, 0, 4, 1, 0, 0, 0, 0, 0, 0, 7
1, 0, 1, 4, 1, 1, 4, 1, 1, 4, 1, 1, 0, 1, 4, 0, 1, 4, 1, 1, 4, 1, 1, 4, 1, 4, 0, 1, 1, 0, 4, 1, 1, 1, 4, 1, 1, 4, 1, 1, 0, 1, 4, 0, 1, 1, 4, 1, 4, 1, 1, 4, 1, 1, 0, 1
4, 0, 1, 4, 1, 4, 1, 4, 1, 1, 4, 1, 0, 1, 1, 0, 1, 1, 4, 1, 1, 4, 1, 1, 4, 1, 0, 1, 4, 0, 1, 1, 4, 1, 1, 4, 1, 1, 4, 1, 0, 1, 1, 0, 4, 1, 4, 1, 1, 4, 1, 1, 1, 1, 0, 4
1, 0, 0, 0, 0, 0, 0, 0, 0, 0, 0, 0, 0, 0, 0, 0, 0, 0, 0, 0, 0, 0, 0, 0, 0, 0, 0, 0, 0, 0, 0, 0, 0, 0, 0, 0, 0, 0, 0, 0, 0, 0, 0, 0, 0, 0, 0, 0, 0, 0, 0, 0, 0, 0, 0, 7
4, 7, 4, 4, 7, 4, 1, 1, 7, 1, 1, 7, 4, 1, 1, 7, 4, 1, 4, 1, 7, 4, 1, 7, 4, 1, 1, 1, 7, 1, 4, 4, 1, 4, 1, 1, 7, 4, 1, 1, 7, 1, 4, 1, 1, 7, 1, 7, 1, 1, 7, 4, 1, 1, 1, 4
