4, 4, 1, 1, 4, 7, 1, 1, 4, 1, 1, 4, 7, 1, 4, 4, 7, 1, 1, 1, 1, 4, 7, 1, 1, 7, 1, 1
1, 0, 0, 0, 0, 0, 0, 0, 0, 0, 0, 0, 0, 1, 4, 0, 0, 0, 0, 0, 0, 0, 0, 0, 0, 0, 0, 7
7, 0, 1, 1, 4, 1, 0, 1, 4, 1, 1, 1, 0, 4, 1, 0, 1, 4, 1, 1, 4, 0, 1, 4, 1, 1, 0, 1
4, 0, 1, 9, 16, 1, 0, 1, 16, 10, 9, 4, 0, 1, 1, 0, 1, 10, 9, 16, 1, 0, 1, 16, 10, 1, 0, 4
1, 0, 1, 4, 1, 1, 0, 4, 1, 1, 1, 1, 0, 4, 1, 0, 1, 4, 1, 1, 4, 0, 1, 1, 1, 4, 0, 7
7, 0, 0, 0, 0, 0, 0, 0, 0, 0, 0, 0, 0, 0, 0, 0, 0, 0, 0, 0, 0, 0, 0, 0, 0, 0, 0, 4
1, 0, 4, 1, 4, 1, 0, 4, 1, 0, 4, 1, 1, 4, 1, 4, 1, 1, 0, 4, 1, 0, 1, 4, 1, 4, 0, 1
4, 0, 1, 1, 4, 1, 0, 4, 1, 0, 1, 4, 1, 4, 4, 1, 4, 1, 0, 1, 4, 0, 1, 1, 4, 1, 0, 4
1, 0, 0, 0, 0, 0, 0, 1, 1, 0, 0, 0, 0, 1, 1, 0, 0, 0, 0, 1, 1, 0, 0, 0, 0, 0, 0, 7
7, 0, 4, 1, 1, 4, 0, 1, 4, 1, 4, 4, 0, 1, 4, 0, 1, 4, 1, 4, 1, 0, 4, 1, 4, 1, 0, 1
1, 0, 4, 16, 9, 1, 0, 4, 1, 4, 1, 1, 0, 4, 1, 0, 4, 1, 1, 4, 1, 0, 1, 9, 9, 4, 0, 7
1, 0, 1, 4, 1, 4, 0, 4, 1, 0, 0, 0, 0, 0, 0, 0, 0, 0, 0, 1, 4, 0, 4, 1, 1, 4, 0, 1
4, 0, 0, 0, 0, 0, 0, 0, 0, 0, 4, 1, 1, 4, 4, 1, 4, 1, 0, 0, 0, 0, 0, 0, 0, 0, 0, 4
1, 1, 7, 1, 7, 1, 1, 4, 7, 1, 1, 4, 7, 4, 1, 1, 7, 4, 1, 4, 7, 1, 4, 7, 7, 1, 1, 4
